((10, 11, 9, 7, 7, 7, 5, 5, 5, 7, 10, 11, 9, 7, 7, 7, 5, 5, 5, 7, 10, 11, 9, 7, 7, 7, 5, 5, 5, 7
8, 10, 9, 6, 5, 5, 3, 3, 3, 5, 8, 10, 9, 6, 5, 5, 3, 3, 3, 5, 8, 10, 9, 6, 5, 5, 3, 3, 3, 5
6, 8, 9, 5, 4, 3, 2, 2, 2, 4, 6, 8, 9, 5, 4, 3, 2, 2, 2, 4, 6, 8, 9, 5, 4, 3, 2, 2, 2, 4
6, 8, 9, 6, 3, 2, 2, 2, 2, 3, 6, 8, 9, 6, 3, 2, 2, 2, 2, 3, 6, 8, 9, 6, 3, 2, 2, 2, 2, 3
7, 9, 7, 4, 3, 2, 2, 2, 2, 5, 7, 9, 7, 4, 3, 2, 2, 2, 2, 5, 7, 9, 7, 4, 3, 2, 2, 2, 2, 5
9, 10, 7, 5, 3, 3, 2, 2, 3, 6, 9, 10, 7, 5, 3, 3, 2, 2, 3, 6, 9, 10, 7, 5, 3, 3, 2, 2, 3, 6
8, 9, 8, 6, 5, 4, 2, 2, 2, 5, 8, 9, 8, 6, 5, 4, 2, 2, 2, 5, 8, 9, 8, 6, 5, 4, 2, 2, 2, 5
7, 8, 8, 7, 6, 5, 4, 4, 3, 4, 7, 8, 8, 7, 6, 5, 4, 4, 3, 4, 7, 8, 8, 7, 6, 5, 4, 4, 3, 4
5, 6, 7, 5, 5, 5, 6, 7, 5, 4, 5, 6, 7, 5, 5, 5, 6, 7, 5, 4, 5, 6, 7, 5, 5, 5, 6, 7, 5, 4
3, 4, 4, 3, 3, 4, 6, 7, 5, 3, 3, 4, 4, 3, 3, 4, 6, 7, 5, 3, 3, 4, 4, 3, 3, 4, 6, 7, 5, 3
2, 2, 2, 2, 1, 3, 5, 6, 5, 3, 2, 2, 2, 2, 1, 3, 5, 6, 5, 3, 2, 2, 2, 2, 1, 3, 5, 6, 5, 3
2, 2, 2, 1, 1, 2, 3, 5, 4, 2, 2, 2, 2, 1, 1, 2, 3, 5, 4, 2, 2, 2, 2, 1, 1, 2, 3, 5, 4, 2
2, 2, 2, 1, 1, 2, 3, 4, 3, 2, 2, 2, 2, 1, 1, 2, 3, 4, 3, 2, 2, 2, 2, 1, 1, 2, 3, 4, 3, 2
2, 3, 2, 2, 2, 3, 5, 5, 4, 2, 2, 3, 2, 2, 2, 3, 5, 5, 4, 2, 2, 3, 2, 2, 2, 3, 5, 5, 4, 2
4, 5, 4, 3, 3, 4, 7, 8, 5, 3, 4, 5, 4, 3, 3, 4, 7, 8, 5, 3, 4, 5, 4, 3, 3, 4, 7, 8, 5, 3
8, 9, 6, 4, 3, 4, 7, 7, 5, 5, 8, 9, 6, 4, 3, 4, 7, 7, 5, 5, 8, 9, 6, 4, 3, 4, 7, 7, 5, 5
13, 14, 9, 4, 4, 4, 4, 5, 4, 7, 13, 14, 9, 4, 4, 4, 4, 5, 4, 7, 13, 14, 9, 4, 4, 4, 4, 5, 4, 7
14, 13, 8, 4, 3, 3, 3, 3, 4, 8, 14, 13, 8, 4, 3, 3, 3, 3, 4, 8, 14, 13, 8, 4, 3, 3, 3, 3, 4, 8
11, 10, 6, 3, 4, 4, 3, 3, 3, 6, 11, 10, 6, 3, 4, 4, 3, 3, 3, 6, 11, 10, 6, 3, 4, 4, 3, 3, 3, 6
8, 8, 6, 5, 5, 5, 4, 3, 4, 5, 8, 8, 6, 5, 5, 5, 4, 3, 4, 5, 8, 8, 6, 5, 5, 5, 4, 3, 4, 5
8, 9, 9, 7, 7, 9, 7, 6, 5, 5, 8, 9, 9, 7, 7, 9, 7, 6, 5, 5, 8, 9, 9, 7, 7, 9, 7, 6, 5, 5
9, 10, 10, 9, 9, 12, 12, 10, 8, 7, 9, 10, 10, 9, 9, 12, 12, 10, 8, 7, 9, 10, 10, 9, 9, 12, 12, 10, 8, 7
11, 12, 12, 11, 11, 14, 15, 13, 11, 10, 11, 12, 12, 11, 11, 14, 15, 13, 11, 10, 11, 12, 12, 11, 11, 14, 15, 13, 11, 10
9, 10, 10, 11, 11, 12, 11, 9, 9, 10, 9, 10, 10, 11, 11, 12, 11, 9, 9, 10, 9, 10, 10, 11, 11, 12, 11, 9, 9, 10
8, 8, 10, 12, 12, 12, 8, 6, 7, 9, 8, 8, 10, 12, 12, 12, 8, 6, 7, 9, 8, 8, 10, 12, 12, 12, 8, 6, 7, 9
5, 6, 9, 12, 11, 9, 6, 4, 5, 6, 5, 6, 9, 12, 11, 9, 6, 4, 5, 6, 5, 6, 9, 12, 11, 9, 6, 4, 5, 6
4, 6, 8, 11, 10, 8, 5, 4, 4, 4, 4, 6, 8, 11, 10, 8, 5, 4, 4, 4, 4, 6, 8, 11, 10, 8, 5, 4, 4, 4
4, 5, 7, 10, 11, 8, 5, 5, 4, 4, 4, 5, 7, 10, 11, 8, 5, 5, 4, 4, 4, 5, 7, 10, 11, 8, 5, 5, 4, 4
6, 7, 7, 10, 11, 10, 7, 6, 6, 6, 6, 7, 7, 10, 11, 10, 7, 6, 6, 6, 6, 7, 7, 10, 11, 10, 7, 6, 6, 6
9, 10, 9, 9, 11, 10, 8, 7, 7, 9, 9, 10, 9, 9, 11, 10, 8, 7, 7, 9, 9, 10, 9, 9, 11, 10, 8, 7, 7, 9))